#######
#O@A  #
#$    #
#     #
#     #
#     #
#######
